1111111111111111111
1P001C0001T00010001
1101110111111111001
10000000T0000000001
1011110111011111101
1T00010000001C100E1
1111011111011011111
1000000C00000000001
1011111111111111101
1T0000000000000C001
1111111111111111111