1111111111111
10010000000C1
10T0011110T01
1P0011E000011
1111111111111
