11111111111111
1P000T00000001
11011111111001
100000000C0T01
10111110111001
1T001C00001001
10111011101001
10000C0000C001
111101111111E1
11111111111111
