1111111111111
1P00000000001
1110111011101
10C0000000C01
1011111111101
1000000000001
1011101110101
1000C000C0001
1111011111101
10000000000E1
1111111111111
