1111111111111111111
1P001C0001100010001
1101110111111111001
1000000000000000001
1011110111011011101
1100010000001C000E1
1111011111011111111
1000000C00000000001
1011111111111111101
11000000000C0000001
1111111111111111111